1111111111111111111111111111111111
1E000N0000000000C00000C000N0000001
10100101001N0000101001000000010101
10100100101N1010001001000000010101
1P0000000C00C0000000000000000000C1
100001000000000001110000000C000001
110N00000000011000N000000001100001
1111111111111111111111111111111111