111111
1N0C01
1PC001
100011
1C1001
100101
1100E1
111111